                               ***************
                               *.............*
                               *.........E...*
**************                 *.............*
*............*******************.............*
*............................................*
*............................................*
*............**********..*******.............*
*....Y...........*    *..*     *.............*
*................*    *..*     ***********..**
*................*    *..*               *..*
******************    *..*               *..*
                *******..***       *******..******
                *..........*       *.............*
                *...E......*       *.............*
                *..........*********.............*
                *................................*
                *................................*
                ********************.............*
                                   *..........O..*
                                   *.............*
                                   ***************