******************
*................*
*............O...*
*................*
*.......**.......*
*.....E..........*
*........*..E....*
*........*.......*
*....Y...*.......*
*........*.......*
******************
