********************
*....C.............*
*..Y....E..s..O....*
*..................*
********************