********************
*....C.............*
*..Y....E..s..O....*
*....P.............*
********************