********************
*..................*
*..Y....E..s..O....*
*..................*
********************