                    *******************                                                                                                          
                  ***                 ******                                                                                                     
                ***                        *******                                                                                               
               ********                          ***                                                          *********                          
              **.......******             *        **         **********                                   ***        *******                    
             **.............****         **.......  *  *******         ***********                     ****                 ********             
             **................***      *.......... ***                          *********          ****                            ***          
            ***..................***  ***..........                                      ******   ***           *******               **         
            * *........Y...........****............ * *********************************       *****     ***   **               *        **       
            ***...................****..............***                               *****    **         *****                *         *       
             **................*****................*                                     ***              ** ***             **         **      
             **............*****...*...............*                                        ****         **     ***          **           *      
              *....................***...........**                                            *         *        **        **            *      
              **.....................***........**                                             *         *         **      **             *      
               ***.....................***....***                                              **        *               ***              *      
                 ****........................**                                                *******  **             ***               **      
                    *****..................***                                                 **********              *                **       
                        ******.........*****                                                  **       ****                      ********        
                             ****..****                                                      **                    ***************               
                               **..**                                                        *         *************                             
                               **..*                                                         *        *                                          
                               *...*                                                         *      **                                           
                              **..**                                                         **     *                                            
                             **  **                                                          **     *                                            
                            **  **                                                           *      *                                            
                           **  **                   ****************                         *     **                                            
                           *  **                  ***              ***                     **      *                                             
                         **  **                 **                   **                   **       *                                             
                         *   *                  *                     *                ***        **                                             
                        **   *                  *                     *               **        ***                                              
                        *    *                  **                    *              **       ***                                                
                        *    *                   **                  *             **      ****                                                  
                        *    *                    **                **            **     ***                                                     
                       **    *                     ***            ***           **      **                                                       
                       *     *                       ******    ****            **     ***                                                        
                       *     **                          ***    **  ********* **    ***                                                          
                       *      **                          ***   *****       ****  ***                                                            
                       **      **                     *****                      *****                                                           
                        *       *                  ****                              *******                                                     
                        **      ***               **                                       ****                                                  
                         **       ***           **                                            ***                                                
                          **        *****       *                                               ***                                              
                            ***         ***    **                                                 **                                             
                              *****       ***  *                                                   **                                            
                                  *****      ***                                                    ***                                          
                                       *****                                                          ***                                        
                                           ****                                                         *                                        
                                              **                                                        *                                        
                                               *                                                        *                                        
                                               **                                                       *                                        
                                                **                                                      *                                        
                                                 **                                                     *                                        
                                                   ***                                                 *                                         
                                                      **                                            ****                                         
                                                     **        ****** ****************   ************                                            
                                                   ***       ***      **            *    *                                                       
                                                  **       ***     ****             *    *                                                       
                                                **        **      **               **    *                                                       
                                             ***         **     **                 *     *                                                       
                                         *****               ****                  *     **                                                      
                                **********                  **                     *      *                                                      
                       **********                          **                      *      *                                                      
                   ****                                    *                       *      **                                                     
                 ***                                       *                      *        **                                                    
               **                                          **                     *         *                                                    
             **                                            **                     *         **                                                   
            **         *******                            **                      *          **                                                  
           **          *******                           **                       **          *           **************                         
         **           ********                         ***                         **          **    *****              *****                    
        **            *******                       ****                            ***         ******                      *****                
      ***                                         ***                                 ****        *                             ****             
     **                                        ****                                      *                 ********                * **          
    **                                       ***                                         **              ***       ****               ***        
   **                             ****     ***                                            ***          ***                               ***     
  **                *******     *****    **                                                ****        *                      ***          **    
  *                  **************     **                                                 ***         *                *********    **     **   
 **                      ********      *                                                   **         **             ****           ***      **  
 *                          ****      *                                                     **        **            **         ********       *  
 *                          ****      *                                                      **        **                   ************      ** 
**                          ***       *                                                       **        **        *        *************       * 
*      **                   *         *                                                        ***       **      **         ***********       ** 
*     *******                         **                                                         ****     *      *                ***        **  
*     **********                      **                                                            ****        **                         **    
*     **********                      * ***                                                             ***********  **********************      
*      *******                            ***                                                                    *    *                          
*       **                                  ***                                                                 **   **                          
*                                    *         ***                                                              *   **                           
*                                   **           ***                                                           **   *                            
**                                 ****             *****                                                     **   **                            
 **                               **  ****               ********                                             *    *                             
   *                            ***      *****                   ******                                      **   **                             
    ***                      ***             *****         ***        ****                           **********  *********                       
       ***                ****                   ****        ***          *****                *******       *           *********               
          ****************                          ****       ****            ***          ****                            ***********          
                                                        ***       *****      **** ***     ******                         ****         ****       
                                                           ***        ********       *** **    ***                    ****               ***     
                                                             **                        ***       **                ****                    ***   
                                                              *****                                **             **                         *** 
                                                                  ******                            **          ***          ****              * 
                                                                       *******                       *          *          ******              **
                                                                              ********               *                   *******                *
                                                                                    ****                               *******                  *
                                                                                     *****                           *******                    *
                                                                                          ****                       *****           O          *
                                                                                             *****                                             **
                                                                                                  ****                                        ** 
                                                                                                      ******                               ****  
                                                                                                            ********               ********      
                                                                                                                   *****************             